"a" = (/turf/unsimulated/cyber/floor,/area/template_noop)
"b" = (/turf/unsimulated/cyber/wall,/area/template_noop)

(1,1,1) = {"
bbaaaaaaaaabb
baaabbabbaaab
aaabaaaaabaaa
aabaaaaaaabaa
abaaaaaaaaaba
abaaaaaaaaaba
aaaaaaaaaaaaa
abaaaaaaaaaba
abaaaaaaaaaba
aabaaaaaaabaa
aaabaaaaabaaa
baaabbabbaaab
bbaaaaaaaaabb
"}
