"a" = (/turf/unsimulated/cyber/floor,/area/template_noop)
"b" = (/turf/unsimulated/cyber/wall,/area/template_noop)

(1,1,1) = {"
aaaaabbbaaaaa
aaaaaaaaaaaaa
aaaaaaaaaaaaa
aaaaaaaaaaaaa
aaaaaaaaaaaaa
baaaaaaaaaaab
baaaaaaaaaaab
baaaaaaaaaaab
aaaaaaaaaaaaa
aaaaaaaaaaaaa
aaaaaaaaaaaaa
aaaaaaaaaaaaa
aaaaabbbaaaaa
"}
