"a" = (/turf/unsimulated/cyber/floor,/area/template_noop)
"b" = (/turf/unsimulated/cyber/wall,/area/template_noop)

(1,1,1) = {"
bbbbbaaabbbbb
bbbaaaaaaabbb
bbaaaaaaaaabb
baaaaaaaaaaab
baaaaaaaaaaab
aaaaaaaaaaaaa
aaaaaaaaaaaaa
aaaaaaaaaaaaa
baaaaaaaaaaab
baaaaaaaaaaab
bbaaaaaaaaabb
bbbaaaaaaabbb
bbbbbaaabbbbb
"}
