"a" = (/turf/unsimulated/cyber/floor,/area/template_noop)
"b" = (/turf/unsimulated/cyber/wall,/area/template_noop)

(1,1,1) = {"
aaaabaaabaaaa
aaaaaaaaaaaaa
aaaabaaabaaaa
aaabbbbbbbaaa
babbaaaaabbab
aaabaaaaabaaa
aaabaaaaabaaa
aaabaaaaabaaa
babbaaaaabbab
aaabbbbbbbaaa
aaaabaaabaaaa
aaaaaaaaaaaaa
aaaabaaabaaaa
"}
