"a" = (/turf/unsimulated/cyber/floor,/area/template_noop)
"b" = (/turf/unsimulated/cyber/wall,/area/template_noop)

(1,1,1) = {"
aaaabaaabaaaa
aaaabaaabaaaa
aaaaaaaaaaaaa
aaaabaaabaaaa
bbabbbabbbabb
aaaabaaabaaaa
aaaaaaaaaaaaa
aaaabaaabaaaa
bbabbbabbbabb
aaaabaaabaaaa
aaaaaaaaaaaaa
aaaabaaabaaaa
aaaabaaabaaaa
"}
