"a" = (/turf/unsimulated/cyber/floor,/area/template_noop)
"b" = (/turf/unsimulated/cyber/wall,/area/template_noop)

(1,1,1) = {"
aaaaaaaaaaaaa
aaabbbbbbbaaa
aaaaaaaaaaaaa
abaaaaaaaaaba
abaaaaaaaaaba
abaaaaaaaaaba
abaaaaaaaaaba
abaaaaaaaaaba
abaaaaaaaaaba
abaaaaaaaaaaa
aaaaaaaaaaaaa
aaabbbbbbbaaa
aaaaaaaaaaaaa
"}
