"a" = (/turf/unsimulated/cyber/floor,/area/template_noop)
"b" = (/turf/unsimulated/cyber/wall,/area/template_noop)

(1,1,1) = {"
aaaaaaaaaaaaa
aaaaaabaaaaaa
aaaaaabaaaaaa
aaaaaabaaaaaa
aaaaaabaaaaaa
aaaaaaaaaaaaa
abbbbaaabbbba
aaaaaaaaaaaaa
aaaaaabaaaaaa
aaaaaabaaaaaa
aaaaaabaaaaaa
aaaaaabaaaaaa
aaaaaaaaaaaaa
"}
