"a" = (/turf/unsimulated/cyber/floor,/area/template_noop)
"b" = (/turf/unsimulated/cyber/wall,/area/template_noop)

(1,1,1) = {"
abbbbbbbbbbba
aaaaaaaaaaaaa
aabaaaaaaabaa
aababbbbbabaa
aabaaaaaaabaa
aabaababaabaa
aabaababaabaa
aabaababaabaa
aabaaaaaaabaa
aababbbbbabaa
aabaaaaaaabaa
aaaaaaaaaaaaa
abbbbbbbbbbba
"}
