"a" = (/turf/unsimulated/cyber/floor,/area/template_noop)
"b" = (/turf/unsimulated/cyber/wall,/area/template_noop)

(1,1,1) = {"
aaaaaaaaaaaaa
baaaaaaaaaaab
babbbbbbbbbab
baaaaaaaaaaab
baabaaaaabaab
baababbbabaab
baabaaaaabaab
baababbbabaab
baabaaaaabaab
baaaaaaaaaaab
babbbbbbbbbab
baaaaaaaaaaab
aaaaaaaaaaaaa
"}
